а=a
я=a
э=e
е=e
ё=o
о=o
ю=u
у=u
и=i
ы=i
б=b
бь=b'
в=v
вь=v'
г=g
гь=g'
д=d
дь=d'
з=z
зь=z'
к=k
кь=k'
л=l
ль=l'
м=m
мь=m'
н=n
нь=n'
п=p
пь=p'
р=r
рь=r'
с=s
сь=s'
т=t
ть=t'
ф=f
фь=f'
х=h
хь=h'
ш=sh
щ=sh'
ж=zh
й=y
ц=ts
ч=ch